11111111111111111111111111111
1P100001C000000010CX010000111
1C000101111100101000011101111
1X111101X001001C1C00C00111011
10000101000110001110110001001
1C11110001000C0010C0100001111
10100001011111111000100100C11
10111C01000000001000101100001
1010CC01111111101101101001101
1C101000000000100101001001001
101111110010X0100101011E010C1
1000C0011110101000010C1111011
1C0010010C1C101011111111C0001
1111100110101011100C0X0000101
1X0C0000C00010000011000100101
11111111111111111111111111111
