1111111111111111111
10000000C00100010C1
1101011111010000011
10010000C1X00P01111
10X1100100000E01111
100C111110110X000C1
1111111111111111111
